T The Start
S magnet

###   ###
#N#   #S#
...   ...
...   ...
...   ...
...   ...
...   ...
....C....
.........
....@....
 ....... 
  .....  