T The Start
S nature

#####   #####
##N##   ##S##
,,,,,   .....
,,,,,   .....
,,,,,   .....
,,,,,   .....
,,,,,   .....
,,,,,   .....
,,,,,   .....
,,,,,   .....
,,,,,   .....
,,,,,   .....
,,,,,, ......
,,,,,,C......
,,,,,,@......
 ,,,,,,..... 
  ,,,,,....  
   ,,,,...   