T Ze Bochs
S magnet
W 5@100 runner,5@100 runner&walker;10@50 walker
W 5@100 runner;5@100 runner&walker;10@50 walker

###############
#N...........S#
#.............#
#.............#
#.............#
#......C......#
#......@......#
#.............#
#.............#
#N...........S#
###############